"a" = (/turf/nature/grass/grass1,/area)
"b" = (/turf/nature/dirt/dirt1,/area)
"c" = (/obj/tree/tree1,/turf/nature/dirt/dirt1,/area)
"d" = (/obj/tree/tree1,/turf/nature/grass/grass1,/area)

(1,1,1) = {"
aabbbaaaaabbbbbbbbaaaabaaaabbbaaaaabbbbbbbbaaaabaa
bbabbaabbabababaabababbaabbabbaabbabababaabababbaa
baaaaaabbaaaaaaaaaaaaabaabaaaaaabbaaaaaaaaaaaaabaa
bbaaaaaaaabaaabaaaaaaaaaabbaaaaaaaabaaabaaaaaaaaaa
aabaaaaaaaabaaaaaaaaaaaaaaabaaaaaaaabaaaaaaaaaaaaa
aabaaaaaaaababaaaaaaaaaaaaabaaaaaaaababaaaaaaaaaaa
abaaacabbabababbaaaaaaaaaabaaacabbabababbaaaaaaaaa
baaaababbaaaaaaaaabaaaaaabaaaababbaaaaaaaaabaaaaaa
baaaaaababbbaaaaaaabbbaaabaaaaaababbbaaaaaaabbbaaa
bbbbabbaabaabaaabaabbaaaabbbbabbaabaabaaabaabbaaaa
abbbbbbbabbbaaaaaaaaaaaaaabbbbbbbabbbaaaaaaaaaaaaa
aabbaaaabaabbabaaaaaaaaaaaabbaaaabaabbabaaaaaaaaaa
ababbbbbabbabbaaaaabaaaaaababbbbbabbabbaaaaabaaaaa
aaaaaabababaaaaaaaaaaabaaaaaaaabababaaaaaaaaaaabaa
aaababaabbaabbbabaaabaabbaaababaabbaabbbabaaabaabb
aabaaaaaaababbaaaaaaaaaaaaabaaaaaaababbaaaaaaaaaaa
aababaabaaaaaaaabaaaaaaaaaababaabaaaaaaaabaaaaaaaa
babbbaaaaaaaaaaaaaabaaaaababbbaaaaaaaaaaaaaabaaaaa
aaaaaabbabaabaaaaaaadabaaaaaaaabbabaabaaaaaaadabaa
aaaaaaabaabbbbbbaaaaaaaaaaaaaaaabaabbbbbbaaaaaaaaa
abbababbbbbabaaaaaaaaaaaaabbababbbbbabaaaaaaaaaaaa
aaabbbbbbbbbbabbabaabbabaaaabbbbbbbbbbabbabaabbaba
aababbaaabbbbbbbbbbbbbbaaaababbaaabbbbbbbbbbbbbbaa
adbbbbbbbbbbbbbaaaabbababadbbbbbbbbbbbbbaaaabbabab
aaaabbbbbbabaababbaaaaaaaaaaabbbbbbabaababbaaaaaaa
aabbbaaaaabbbbbbbbaaaabaaaabbbaaaaabbbbbbbbaaaabaa
bbabbaabbabababaabababbaabbabbaabbabababaabababbaa
baaaaaabbaaaaaaaaaaaaabaabaaaaaabbaaaaaaaaaaaaabaa
bbaaaaaaaabaaabaaaaaaaaaabbaaaaaaaabaaabaaaaaaaaaa
aabaaaaaaaabaaaaaaaaaaaaaaabaaaaaaaabaaaaaaaaaaaaa
aabaaaaaaaababaaaaaaaaaaaaabaaaaaaaababaaaaaaaaaaa
abaaacabbabababbaaaaaaaaaabaaacabbabababbaaaaaaaaa
baaaababbaaaaaaaaabaaaaaabaaaababbaaaaaaaaabaaaaaa
baaaaaababbbaaaaaaabbbaaabaaaaaababbbaaaaaaabbbaaa
bbbbabbaabaabaaabaabbaaaabbbbabbaabaabaaabaabbaaaa
abbbbbbbabbbaaaaaaaaaaaaaabbbbbbbabbbaaaaaaaaaaaaa
aabbaaaabaabbabaaaaaaaaaaaabbaaaabaabbabaaaaaaaaaa
ababbbbbabbabbaaaaabaaaaaababbbbbabbabbaaaaabaaaaa
aaaaaabababaaaaaaaaaaabaaaaaaaabababaaaaaaaaaaabaa
aaababaabbaabbbabaaabaabbaaababaabbaabbbabaaabaabb
aabaaaaaaababbaaaaaaaaaaaaabaaaaaaababbaaaaaaaaaaa
aababaabaaaaaaaabaaaaaaaaaababaabaaaaaaaabaaaaaaaa
babbbaaaaaaaaaaaaaabaaaaababbbaaaaaaaaaaaaaabaaaaa
aaaaaabbabaabaaaaaaadabaaaaaaaabbabaabaaaaaaadabaa
aaaaaaabaabbbbbbaaaaaaaaaaaaaaaabaabbbbbbaaaaaaaaa
abbababbbbbabaaaaaaaaaaaaabbababbbbbabaaaaaaaaaaaa
aaabbbbbbbbbbabbabaabbabaaaabbbbbbbbbbabbabaabbaba
aababbaaabbbbbbbbbbbbbbaaaababbaaabbbbbbbbbbbbbbaa
adbbbbbbbbbbbbbaaaabbababadbbbbbbbbbbbbbaaaabbabab
aaaabbbbbbabaababbaaaaaaaaaaabbbbbbabaababbaaaaaaa
"}
