"a" = (/turf/nature/grass/grass1,/area)
"b" = (/obj/tree/tree1,/turf/nature/grass/grass1,/area)
"c" = (/turf/nature/grass/grass2,/area)
"d" = (/turf/nature/dirt/dirt1,/area)
"e" = (/turf/nature/dirt/dirt2,/area)
"f" = (/turf/nature/dirt/dirt3,/area)

(1,1,1) = {"
aaaaaaaaaaaaaaaaaaaaaaaaaaaaaaaaaaaaaaaaaaaaaaaaaa
aaaaaaaaaaaaaaaaaaaaaaaaaaaaaaaaaaaaaaaaaaaaaaaaaa
aaaaaaaaaaaaaaaaaaaaaaaaaaaaaaaaaaaaaaaaaaaaaaaaaa
aaaaaaaaaaaaaaaaaaaaaaaaaaaaaaaaaaaaaaaaaaaaaaaaaa
aaaaaaaaaaaaaaaaaaaaaaaaaaaaaaaaaaaaaaaaaaaaaaaaaa
aaaaaaaaaaaaaaaaaaaaaaaaaaaaaaaaaaaaaaaaaaaaaaaaaa
aaaaaaaaaaaaaaaaaaaaaaaaaaaaaaaaaaaaaaaaaaaaaaaaaa
aaaaaaaaaaaaaaaaaaaaaaaaaaaaaaaaaaaaaaaaaaaaaaaaaa
aaaaaaaaaaaaaaaaaaaaaaaaaaaaaaaaaaaaaaaaaaaaaaaaaa
aaaaaaaaaaaaaaaaaaaaaaaaaaaaaaaaaaaaaaaaaaaaaaaaaa
aaaaaaaaaaaaaaaaaaaaaaaaaaaaaaaaaaaaaaaaaaaaaaaaaa
aaaaaaaaaaaaaaaaaaaaaaaaaaaaaaaaaaaaaaaaaaaaaaaaaa
aaaaaaaaaaaaaaaaaaaaaaaaaaaaaaaaaaaaaaaaaaaaaaaaaa
aaaaaaaaaaaaaaaaaaaaaaaaaaaaaaaaaaaaaaaaaaaaaaaaaa
aaaaaaaaaaaaaaaaaaaaaaaaaaaaaaaaaaaaaaaaaaaaaaaaaa
aaaaaaaaaaaaaaaaaaaaaaaaaaaaaaaaaaaaaaaaaaaaaaaaaa
aaaaaaaaaaaaaaaaaaaaaaaaaaaaaaaaaaaaaaaaaaaaaaaaaa
aaaaaaaaaaaaaaaaaaaaaaaaaaaaaaaaaaaaaaaaaaaaaaaaaa
aaaaaaaaaaaaaaaaaaaaaaaaaaaaaaaaaaaaaaaaaaaaaaaaaa
aaaaaaaaaaaaaaaaaaaaaaaaaaaaaaaaaaaaaaaaaaaaaaaaaa
aaaaaaaaaaaaaaaaaaaaaaaaaaaaaaaaaaaaaaaaaaaaaaaaaa
aaaaaaaaaaaaaaaaaaaaaaaaaaaaaaaaaaaaaaaaaaaaaaaaaa
aaaaaaaaaaaaaaaaaaaaaaaaaaaaaaaaaaaaaaaaaaaaaaaaaa
aaaaaaaaaaaaaaaaaaaaaaaaaaaaaaaaaaaaaaaaaaaaaaaaaa
aaaaaaaaaaaaaaaaaaaaaaaaaaaaaaaaaaaaaaaaaaaaaaaaaa
aaaaaaaaaaaaaaaaaaaaaaaaaaaaaaaaaaaaaaaaaaaaaaaaaa
aaaaaaaaaaaaaaaaaaaaaaaaaaaaaaaaaaaaaaaaaaaaaaaaaa
aaaaaaaaaaaaaaaaaaaaaaaaaaaaaaaaaaaaaaaaaaaaaaaaaa
aaaaaaaaaaaaaaaaaaaaaaaaaaaaaaaaaaaaaaaaaaaaaaaaaa
aaaaaaaaaaaaaaaaaaaaaaaaaaaaaaaaaaaaaaaaaaaaaaaaaa
aaaaaaaaaaaaaaaaaaaaaaaaaaaaaaaaaaaaaaaaaaaaaaaaaa
aaaabaaaaaaaaaaaaaaaaaaaaaaaaaaaaaaaaaaaaaaaaaaaaa
aaaaaaaaaabaaaaaaaaaaaaaaaaaaaaaaaaaaaaaaaaaaaaaaa
aaaaaaaaaaaacccaaaaaaaaaaaaaaaaaaaaaaaaaaaaaaaaaaa
aaaaaababaccccccaaaaaaaaaaaaaaaaaaaaaaaaaaaaaaaaaa
abaaaaaccccddddccaaaaaaaaaaaaaaaaaaaaaaaaaaaaaaaaa
aaaaaccaccddeedccaaaaaaaaaaaaaaaaaaaaaaaaaaaaaaaaa
aaaabaaccdddffdccaaaaaaaaaaaaaaaaaaaaaaaaaaaaaaaaa
aaaaaaccddeffedccaaaaaaaaaaaaaaaaaaaaaaaaaaaaaaaaa
aaaaacccddfffedccaaaaaaaaaaaaaaaaaaaaaaaaaaaaaaaaa
aaaacccddfffeddccaaaaaaaaaaaaaaaaaaaaaaaaaaaaaaaaa
abacccdeeffeddccbaaaaaaaaaaaaaaaaaaaaaaaaaaaaaaaaa
acccddefffeedccaaaaaaaaaaaaaaaaaaaaaaaaaaaaaaaaaaa
cccddeeffeedccaaaaaaaaaaaaaaaaaaaaaaaaaaaaaaaaaaaa
ccddefffeedccabaabaaaaaaaaaaaaaaaaaaaaaaaaaaaaaaaa
cddefffeedcccaaaaaaaaaaaaaaaaaaaaaaaaaaaaaaaaaaaaa
ddeffeeedccccaabaaaaaaaaaaaaaaaaaaaaaaaaaaaaaaaaaa
eefffeeddcccbaaaaaaaaaaaaaaaaaaaaaaaaaaaaaaaaaaaaa
ffffedddcccaabaaaaaaaaaaaaaaaaaaaaaaaaaaaaaaaaaaaa
fffeddcccabaaaaaaaaaaaaaaaaaaaaaaaaaaaaaaaaaaaaaaa
"}
